Nom De Map Beaucoup trop bien
25
8

PPPFFFFFPPMMMPPPPPPRRPPMP
PPPPFPFPPPMPPPPPVPRFPPMMM
PPVPPPPVPMPPPVPFPPRFFFPPP
PPPPPMPFMMMPFFFFPPRRFFFPP
PPPMMMFFFFMPFFFFPRRRFFVPP
PVVVMPFFFMPPPPFPRPPRFPPVP
PPVPPPPPMMMPVPPRRPVPRPPPP
PPPPPPPMMMMMPPPRPPPPRRPPP
